Undefeated |AtlasParkTour1
Silent Sentinel |AtlasParkTour2
Hero Corps Insider::Hero Corps Infiltrator |AtlasParkTour3
Patriot::International Spy |AtlasParkTour4
Top Dog |AtlasParkTour5
Freedom::Covert Operator |AtlasParkTour6
Edge of Chaos |AtlasParkTour7
Observant |AtlasParkTour8
Bird Watcher |GalaxyCityTour1
Blue Shield |GalaxyCityTour2
Brawler |GalaxyCityTour3
Tank |GalaxyCityTour4
Land Locked |GalaxyCityTour5
Galactic Fan |GalaxyCityTour6
Eye of the Gemini |GalaxyCityTour7
Orion's Belt |GalaxyCityTour8
Summoned |KingsRowTour1
Upgraded |KingsRowTour2
Mystic King/Queen |KingsRowTour3
Keen Sighted |KingsRowTour4
Smokey |KingsRowTour5
Wentworth History Buff |KingsRowTour6
Pwned |KingsRowTour7
Man/Woman of Vengeance |KingsRowTour8
Secret Admirer |SteelCanyonTour1
Hero Corps Recruit::Hero Corps Reject |SteelCanyonTour2
Nimble Mynx |SteelCanyonTour3
Bright Star |SteelCanyonTour4
Dance Legend |SteelCanyonTour5
Controversial |SteelCanyonTour6
Pet Project |SteelCanyonTour7
Dirty Attorney |SteelCanyonTour8
Purifier::Defiler |SkywayCityTour1
Solace |SkywayCityTour2
Dauntless |SkywayCityTour3
Healing Node |SkywayCityTour4
Better Days |SkywayCityTour5
Room for Expansion |SkywayCityTour6
Left Behind |SkywayCityTour7
Bridge to Nowhere |SkywayCityTour8
Undammed |FaultlineTour1
Newsman/girl |FaultlineTour2
Faultless Mystic |FaultlineTour3
Apex |FaultlineTour4
Escape Artist |FaultlineTour5
Drowned Rat |FaultlineTour6
Old Fashioned |FaultlineTour7
Egg Hunter |FaultlineEaster
Minotaur |TalosIslandTour1
Nature Lover::Eco-warrior |TalosIslandTour2
Whitecap |TalosIslandTour3
Last Line of Defense |TalosIslandTour4
The Old Me |TalosIslandTour5
Bridge Holder |TalosIslandTour6
Overtime Worker |TalosIslandTour7
Spanky's Competitor |TalosIslandTour8
Crey Havoc |IndependancePortTour1
Valorous |IndependancePortTour2
Vigorous |IndependancePortTour3
Air Lifter |IndependencePortTour4
Dead End |IndependencePortTour5
Family Partier |IndependencePortTour6
Connector |IndependencePortTour7
Unlucky |IndependencePortTour8
Grim Wanderer |CroatoaTour1
Spiritual |CroatoaTour2
Ensorcelled |CroatoaTour3
Jack's Wrath |CroatoaTour6
Barrier Holder |CroatoaTour4
Sally Sightseer |CroatoaTour5
Waylon's Observer |CroatoaTour7
Midnighter's Perseverance |CroatoaTour8
Mystic |BrickstownTour1
Inmate |BrickstownTour2
Flying Shark |BrickstownTour3
Fugitive |BrickstownTour4
Forward Thinker |BrickstownTour5
Secret Path |BrickstownTour6
Sixth Passenger |BrickstownTour7
Unsubtle |BrickstownTour8
Foggy |FoundersFallsTour1
Chaotician |FoundersFallsTour2
Guardian Angel::Barely Contained |FoundersFallsTour3
Losing Paradise |FoundersFallsTour4
Watchful Eyes |FoundersFallsTour5
Hamidon's Fury |FoundersFallsTour6
Founders' Hero::Founders' Loss |FoundersFallsTour7
Misunderstood |FoundersFallsTour8
Portal Parter |PeregrineIslandTour1
Use Might for Right::Rookie's Mistake |PeregrineIslandTour2
Cause for Concern |PeregrineIslandTour3
Genetically Altered |PeregrineIslandTour4
Rikti Gone Wild |PeregrineIslandTour5
Shades of Arachnos |PeregrineIslandTour6
All-Seeing |PeregrineIslandTour7
Dark Omen |PeregrineIslandTour8
Spirit of the City |SewerNetworkTour1
Plutonian |SewerNetworkTour2
Baumton Avenger |SewerNetworkTour3
Sewer Queen/King |SewerNetworkTour4
Sewer Stalker |SewerNetworkTour5
Downward Bound |SewerNetworkTour6
Terror of the Vahzilok |SewerNetworkTour7
Seeker of the Lost |SewerNetworkTour8
Head of the Hydra |AbandonedSewersTour1
Boomtown Refugee |AbSewerNetworkTour1
Hades Aspirant |AbSewerNetworkTour2
Secret of the City |AbSewerNetworkTour3
Sprawl Survivor |AbSewerNetworkTour4
The Underlord/lady |AbSewerNetworkTour5
From Beneath You |AbSewerNetworkTour6
Living Dark |AbSewerNetworkTour7
Persephone Supplicant |AbSewerNetworkTour8
Parapsychologist |HollowsTour1
Seeker of Monsters |HollowsTour2
Geologist |HollowsTour3
Backwoodsman |HollowsTour4
Gangland Fury |HollowsTour5
Graffiti Communicator |HollowsTour6
Circle Seeker |HollowsTour7
Ironic |HollowsTour8
Territorial |PerezParkTour1
Avatar |PerezParkTour2
Around the Bendis |PerezParkTour3
Doc Whedon |PerezParkTour4
Justice Avenger::Social Climber |PerezParkTour5
Nebula's Memory |PerezParkTour6
Blood Moss |PerezParkTour7
Ophelia's Final Scene |PerezParkTour8
Phalanxer |BoomtownTour1
Regal |BoomtownTour2
Vision of Despair |BoomtownTour3
Destined for Valhalla |BoomtownTour4
Towering Inferno |BoomtownTour5
Boomtown Troglodyte |BoomtownTour6
End of the Line |BoomtownTour7
Corpse Box |BoomtownTour8
Super Spy |StrigaTour1
Sea Dog |StrigaTour2
Vulcanologist |StrigaTour3
The Wolf's Snarl |StrigaTour4
Words of the Warrior |StrigaTour5
The Unnamed |StrigaTour6
The Wolf's Maw |StrigaTour7
Vampyri Watcher |StrigaTour8
Conjunction Junction |TerraVoltaTour1
Meltdown |TerraVoltaTour2
Nervous Dreck |TerraVoltaTour3
Guardian of the Volts |TerraVoltaTour4
Danger! Danger! |TerraVoltaTour5
Scrapheap of History |TerraVoltaTour6
Power Walker |TerraVoltaTour7
High Voltage! |TerraVoltaTour8
Dark Mystic |DarkAstoriaTour1
Seeker of the Unknown |DarkAstoriaTour2
Cairn Warder |DarkAstoriaTour3
Whisperer on Witchburn Hill |DarkAstoriaTour4
Phantom Radio |DarkAstoriaTour5
Too Dark Park |DarkAstoriaTour6
Astoria's Last Stand |DarkAstoriaTour7
The Sleeper Below |DarkAstoriaTour8
Crey Watcher |CreysFolleyTour1
Burning the Midnight Oil |CreysFolleyTour2
Eyes of Nemesis |CreysFolleyTour3
Hammer of the Rikti |CreysFolleyTour4
Veni, Vidi, Vici |CreysFolleyTour5
Crey Cares |CreysFolleyTour6
Freak's Folly |CreysFolleyTour7
Cirque du'Freak |CreysFolleyTour8
Crey Fish |EdenTour1
Unspoiled |EdenTour2
Call of Nature |EdenTour3
Nature's Wrath |EdenTour4
Natural Law |EdenTour5
The Devouring Earth Abides |EdenTour6
Hive Mind |EdenTour7
Natural Selection |EdenTour8
Time Bandit |TheHiveTour1
Heart of the Hamidon |TheHiveTour2
Babe in the Woods |TheHiveTour3
The Wounded Earth |TheHiveTour4
Wild At Heart |TheHiveTour5
Among the Giants |TheHiveTour6
The Sound of Thunder |TheHiveTour7
Forest of Stone |TheHiveTour8
Defying Gravity |FirebaseZuluTour1
Dimensional Sojourner |FirebaseZuluTour2
Stormwatcher |FirebaseZuluTour3
Alpha Ranger |FirebaseZuluTour4
Shadow Architect |FirebaseZuluTour5
X-Ray Spectator |FirebaseZuluTour6
Dancer with Death |FirebaseZuluTour7
Shard Leaper |FirebaseZuluTour8
Castaway |CascadeArchTour1
Peace Walker |CascadeArchTour2
Being and Nothingness |CascadeArchTour3
Hearing Voices |CascadeArchTour4
Liquid Memory |CascadeArchTour5
Usurper of Worlds |CascadeArchTour6
No Turning Back Now |CascadeArchTour7
The Heart of Memory |CascadeArchTour8
King/Queen of Pain |ChantryTour1
Unfettered |ChantryTour2
Penitent |ChantryTour3
Misbegotten |ChantryTour4
Bereaved |ChantryTour5
Dispossessed |ChantryTour6
Red Fog |ChantryTour7
Demiurge |ChantryTour8
Courting Madness |StormPalaceTour1
Acolyte of Anger |StormPalaceTour2
Malice Aforethought |StormPalaceTour3
Tormented |StormPalaceTour4
Hate Machine |StormPalaceTour5
Fist of Fury |StormPalaceTour6
Eve of Destruction |StormPalaceTour7
Lord/Lady of Storms |StormPalaceTour8
Jail Bird |TutorialTour3
Cesspool |MercyIslandTour1
Snake Charmer |MercyIslandTour2
Chum |MercyIslandTour3
Fortified |MercyIslandTour4
The Next Big Thing |MercyIslandTour5
Widower/Widow |MercyIslandTour6
First Rule |MercyIslandTour7
Tiki Fan |MercyIslandTour8
Scurvy Dog |PortOakesTour1
Washed Up |PortOakesTour2
Powder Monkey |PortOakesTour3
Driller |PortOakesTour4
Long Walk |PortOakesTour5
Big Spider |PortOakesTour6
Commuter's Woe |PortOakesTour7
Hidden Getaway |PortOakesTour8
Sparky |CapauDiableTour1
Media Junky |CapauDiableTour2
Egghead |CapauDiableTour3
Steamed |CapauDiableTour4
Sweet Tooth |CapauDiableTour5
Doom Sayer |CapAuDiableTour6
Master of Science |CapAuDiableTour7
Circle Gazer |CapAuDiableTour8
Razor Toothed |SharkheadTour1
Forged by Hellfire |SharkheadTour2
Freak of Nature |SharkheadTour3
Pit Viper |SharkheadTour4
Sky Chaser |SharkheadTour5
Unwelcome Guest |SharkheadTour6
Sky Trader |SharkheadTour7
Carping the Diem |SharkheadTour8
Watcher on the Knoll |NervaTour1
Locked and Loaded |NervaTour2
Nerva Wreck |NervaTour3
Primal Instinct |NervaTour4
Tree Hugger |NervaTour5
Unethical Tourist |NervaTour6
Blind Eye |NervaTour7
Soother |NervaTour8
Deuces Wild |StMartialTour1
Paroled::Crimelord |StMartialTour2
Stonekeeper |StMartialTour3
Camel Snot |StMartialTour4
Dead Man's Tree |StMartialTour5
Social Worker::Slumlord |StMartialTour6
Infamous Rubble |StMartialTour7
Showstopper |StMartialTour8
Overlord |GrandvilleTour1
Sewer Dweller |GrandvilleTour2
Guttersnipe |GrandvilleTour3
Master/Mistress of the Airwaves |GrandvilleTour4
Passing Fab |GrandvilleTour5
Image Crasher |GrandvilleTour6
Line Holder |GrandvilleTour7
Gutter Bait |GrandvilleTour8
Reborn |AbyssTour1
Geneticist |AbyssTour2
Here Be Dragons |AbyssTour3
Caged Beast |AbyssTour4
No Escape |AbyssTour5
Hamidon's Ire |AbyssTour6
The Tree of Woe |AbyssTour7
Abyssal Gaze |AbyssTour8
Monster Islander |MonsterIslandTour1
The Roar of the Beast |MonsterIslandTour2
Rikti Monkey Island |MonsterIslandTour3
Monsters' Playthings |MonsterIslandTour4
Dark Garden |MonsterIslandTour5
Grim Fandango |MonsterIslandTour6
Misfit Monstrosity |MonsterIslandTour7
Monster Factory |MonsterIslandTour8
Clockwork Mechanic |P_ClockworkMechanic
Disappeared |P_Disappeared
Ferryman/woman of the Damned |P_FerrymanOfTheDamned
Morbid |P_Morbid
Secret Prisoner |P_SecretPrisoner
Trainspotter |P_Trainspotter
Urban Spelunker |P_UrbanSpelunker
Warrior at the Gate |P_WarriorAtTheGate
Ambitious |P_Ambitious
Citizen Cole |P_CitizenCole
Civic Minded |P_CivicMinded
Guardians of Justice |P_GuardiansOfJustice
Into the Wild |P_IntoTheWild
Technophile |P_Technophile
Un-Civil Society |P_UnCivilSociety
On the Waterfront |P_Waterfront
Broken Mind |P_BrokenMind
Condemning |P_Condemning
Engineer |P_Engineer
Eyes of the Dark |P_EyesOfTheDark
Hoarder |P_Hoarder
Lowlife |P_Lowlife
Silent Witness |P_SilentWitness
Underground Explorer |P_UndergroundExplorer
Gold Digger |P_GoldDigger
Mercy Missionary |P_MercyMissionary
Park Ranger |P_ParkRanger
Praetorian of Privilege |P_PraetorianOfPrivilege
Seen |P_Seen
Seer |P_Seer
Tiberian Overseer |P_TiberianOverseer
Tuned In |P_TunedIn
Going Rouge |P_GoingRouge
Binge Eater |P_BingeEater
Cluttered |P_Cluttered
Drink Enriche! |P_DrinkEnriche
Grade F |P_GradeF
Keeping the Lights On |P_KeepingTheLightsOn
Ready for Anything |P_ReadyForAnything
Nailbiter |P_Nailbiter
The New Boss |P_TheNewBoss
Airlift |P_Airlift
Don't Drink It |P_DontDrinkIt
Eyes to the Future |P_EyesToTheFuture
Longshoreman/woman |P_Longshoreman
Moar Power |P_MorePower
Stockpiling |P_Stockpiling
Stuff of Life |P_StuffOfLife
Urban Renewal |P_UrbanRenewal
River Rat |P_RiverRat
Rail Rider |P_RailRider
Ace |RiktiCrashSiteTour1
Vanguard Operative |RiktiWarZoneTour1
Trespasser |RiktiWarZoneTour2
Powerful |RiktiWarZoneTour3
Lifesaver |RiktiWarZoneTour4
Under Fire |RiktiWarZoneTour5
Base Jumper |RiktiWarZoneTour6
Homewrecker |RiktiWarZoneTour7
Luscious |RiktiWarZoneTour8
Junkyard Dog |RiktiWarZoneTour9
Scarred |RiktiWarZoneTour10
Asunder |RiktiWarZoneTour11
Unabashed |RiktiWarZoneTour12
Eyewitness |RiktiWarZoneTour13
Big Time |BigTime
Trucker |TruckerTour
Lobbyist::Crooked Politician |BloodyBayTour1
Hungry::All Consuming |BloodyBayTour2
Imploding |BloodyBayTour3
Ghoulish |BloodyBayTour4
Hangman/woman |SirensCallTour1
Politician |SirensCallTour2
Broad Shoulders |SirensCallTour3
Piratical |SirensCallTour4
Weapon Inspector::Weapon of Mass Destruction |WarburgTour1
Tunnel Rat |WarburgTour2
Triumphant |WarburgTour3
Globetrotter |ReclusesVictoryTour1
Ragnarok |ReclusesVictoryTour2
Temporal Fighter::Dark Victory |ReclusesVictoryTour3
Last Stand |ReclusesVictoryTour4
Heart of the City::Hate of the City |SafeguardMap1
King's Righteousness::King's Capriciousness |SafeguardMap2
Courage Driven::Rage Driven |SafeguardMap3
Freedom's Defender::Freedom's Crusher |SafeguardMap4
Honorable Captain::Dishonorable Captain |SafeguardMap5
Talos' Might::Talos' Blight |SafeguardMap6
Cornerstone::Weak Point |SafeguardMap7
Founders' Protector::Founders' Invader |SafeguardMap8
Gatekeeper::Keymaster |SafeguardMap9
Global Guardian::Global Threat |MayhemMap1
King Maker |MayhemMap2
Road Raged |MayhemMap3
Steel Worker |MayhemMap4
Revolutionary::Tyrannical |MayhemMap5
Talon of Talos |MayhemMap6
Brickhouse |MayhemMap7
Libertarian::Anarchist |MayhemMap8
Gate Closer::Gate Crasher |MayhemMap9
Cage Fighter |CageFighter
Multidimensional |HydraDimension1
Shrouded::Shady |BlackShroudDimension1
Chrononaut |OuroborosTour1
Depths of Time |CimeroraTour1
Midnighter Club Member |MSClubTour1
Thrill Seeker |MissionArchitectTourism
Pupil |AtlasHistory
Student |CitizenCrimeAct
Scholastic |DimensionalBarrier
Authority |FreedomPhalanx
Disciple |HeroCorps
Expert |MightForRightAct
Academic |NemesisSeizesControl
Intellectual |PsychicFeedbackLoop
Savant |RiktiWar
Researcher |SpankyRabinowitz
Historian |SpecialCouncil
Just Said No to Superadine |Superadine
Scholar |WarOnDrugs
Digger |Hollowing
Ghost Hunter |Ghostship
Alumnus |CroatoaHistory
Arachnos Rising |RecluseArrival
Lorekeeper |CoTMu
Swashbuckler |PirateHistory
Technofreak |Experiments
Headjuiced |P_KnowledgeisPower
Starstruck |P_Starstruck
Midnighter Archivist |Midnight_Mystery
Rule of Three |PositronRevampPart1
Dam Hero::Dam Villain |PositronRevampPart2
Positron's Ally::Positron's Betrayer |PositronTF
Synapse's Cohort::Synapse's Betrayer |SynapseTF
Sister Psyche's Comrade::Sister Psyche's Betrayer |SisterPsycheTF
Citadel's Assistant::Citadel's Betrayer |BastionTF
Manticore's Associate::Manticore's Betrayer |ManticoreTF
Numina's Compatriot::Numina's Betrayer |NuminaTF
Honorary Peacebringer::Alien Fighter |StrigaTF
Cabalist |CroatoaTF
Burkholder's Bane |CouncilRobot
Column Breaker |5thColumnHero
Portal Smasher |ShardTF1
Destroyer of Strength |ShardTF2
Protector of Kindness::Thorn Crusher |ShardTF3
Slayer of Madness |ShardTF4
Saved the World::Saved the World... For Later |STFVictory
Peerless::Recluse's Rival |STFVictory2
Binder of Beasts |BatzulSF
Pirate Hunter::Air Pirate |SkyRaiderSF
Leviathan |WaterTempleSF
Crystal Keeper |SerafinaCrystalSF
Former Servant of Recluse::Servant of Recluse |LordRecluseTF
Arbiter |5thColumnVillain
Apocalyptic |VanguardCoOpTF
Pain Killer |CoPComplete
Temporal Strife |TAComplete
Alpha Struck |AlphaTF_Complete_TinMage
Weapon Master/Warrior Princess |AlphaTF_Complete_Apex
Transcendent |HollowsTR
Transmogrified |TerraVoltaTR
Charmer |SewerTR
Liberator::Destroyer of Earth |EdenTR
Negotiator |SL2Mission
Spelunker |SL2Point5Mission
Plague Stopper::Deadly Virus |SL3Mission
Spirit Warrior |SL4MissionA
Pwnz |SL4MissionB
Redeemer::Conqueror |SL5MissionA
Mystical Savior::Mystical Adept |SL5MissionB
Corrupter |SL6MissionA
War Wall Defender::Saboteur |SL6MissionB
The Doctor's Ally |SL7MissionA
Frontline |SL7MissionB
Emancipator |SL8MissionA
Meteorologist |SL8MissionB
Bodyguard |SL9MissionA
Agent |SL9MissionB
The Fairest::Turf Protector |I11HeroStoryArc1Complete
Singular Vision |I11HeroStoryArc2Complete
Helping Hands |I19HeroStoryArcComplete
Plague Carrier |VSL2.5MissionA
Mask Maker |VSL2.5MissionB
Stone Cold |VSL2MissionA
Bone Collector |VSL2MissionB
Penitent of Vice::Paragon of Vice |VSL3MissionA
Seaweed |VSL3MissionB
Strikebreaker |VSL4MissionA
Slag Reaper |VSL4MissionB
Agent of Discord |VSL5MissionA
Soul Taker |VSL5MissionB
Bad Luck |VSL6MissionA
Exterminator |VSL6MissionB
Skip Tracer |VSL7MissionA
Portal Hopper |VSL7MissionB
Party Crasher |VSL8MissionA
Mage Hunter |VSL8MissionB
Efficiency Expert |VSL9MissionA
Couch Potato |VSL9MissionB
Bane of Ajax |I11VillainStoryArc1Complete
Explosive Finale |I11VillainStoryArc2Complete
Keeper of the Coral Lore |I19VillainStoryArcComplete
Member of Vanguard |VanguardEnabled
The Thief of Midnight |MSThief
Midnight Squad |MSMember
Lost Savior |MSLost
Origin of Power |MSOrigin
Rescuer::Big Softie |Yin
Avid Reader |P_Tutorial_Reader
Denial of Service |P_DenialofService
Moral High Ground |P_5MoralChoice
Resistance Member |P_Resistance
Loyalist |P_Loyalist
Tipped Off |P_GotTip
Walking the Path |P_AlignmentMission
Ear to the Street |P_HeroAlignmentMission
Streetwise |P_VigilanteAlignmentMission
Well Informed |P_RogueAlignmentMission
Inquisitor |P_VillainAlignmentMission
Tested the Water |P_OtherAlignmentMission
Made a Stand |P_MoralityMission
Empowered |P_BuildCommonIA
Initiate |P_BuildUncommonIA
Speed Demon |SlolamGold
Accelerated |SlolamSilver
Qualified |SlolamBronze
Speeder |SlolamGold2
Agile |SlolamSilver2
Surefooted |SlolamBronze2
Laureate |P_Antilaureate
Protester |P_Protestor
Takedown Artist |P_TakedownArtist
Reformed Firebug::Firebug |MayhemFirebug
Pedestrian::Impounder |MayhemImpounder
Fire Marshal::Fired |SafeguardFireMarshal
Bomb Squad::Blue Wire |SafeguardBombSquad
PPD Deputy::Disgraced Deputy |SafeguardPPDDeputy
Security Expert::Inside Man/Woman |SafeguardSecurityExpert
Interceptor |SafeguardInterceptor
Master of Statesman's Task Force |MasterofStatesmansTaskForce
Master of Lord Recluse's Strike Force |MasterofLordReclusesStrikeForce
Master of the 5th Column Strike Force |MasterofReichsmansStrikeForce
Master of the 5th Column Task Force |MasterofReichsmansTaskForce
Master of the Imperious Task Force |MasterofImperiousTaskForce
Master of Lady Grey's Task Force |MasterofLadyGreysTaskforce
Master of Tin Mage Task Force |AlphaTF_Master_TinMage
Master of Apex Task Force |AlphaTF_Master_Apex
Already Dead |AlphaTF_BattleMaidenQuick
Army of Neu |AlphaTF_NeuronClones
Burden Bearer::Arm's Length |AlphaTF_DronesUnused
Drone Protector |AlphaTF_DronesAlive
Hacker |AlphaTF_ComputersQuick
Kitty's Got Claws |AlphaTF_BobcatMaxed
Midnight Dodger What Dodges at Midnight |AlphaTF_NoProximityBombs
Gallant |P_HeroAlignment
Above the Law |P_VigilanteAlignment
Scoundrel |P_RogueAlignment
Dastardly |P_VillainAlignment
Heard the Call |P_HeroAlignmentPower
Fearsome |P_VigilanteAlignmentPower
Trickster |P_RogueAlignmentPower
Frenzied |P_VillainAlignmentPower
Ascended |P_Ascended
Descended |P_Descended
Come Full Circle |P_ComeFullCircle
Grass Is Meaner::Grass is Greener |P_TravelBetweenCities
Protector of Innocents::Soldier |Level10P_Level_10
Keeper of Peace::Insider |Level20P_Level_20
Defender of Truth::Wiseguy/gal |Level30P_Level_30
Justice Incarnate::Captain |Level40P_Level_40
Hero of the City::Made |Level50P_Level_50
Praetorian Professional |P_Level_10Level10
Survivor of Praetoria |P_Level_20Level20
Rift Traveler |P_Level_30Level30
Primal Praetorian |P_Level_40Level40
Praetor |P_Level_50Level50
Celebrity::Bling |CelebrityP_Money_500K
Sensation::Mr./Mrs. Big |SensationP_Money_2500K
Superstar::Midas Touch |SuperstarP_Money_10M
Trendsetter |MultimillionaireP_Money_50M
Popular |BillionaireP_Money_250M
Leader |TrillionaireP_Money_500M
Who's Who |P_Money_500KCelebrity
Acclaimed |P_Money_2500KSensation
Illustrious |P_Money_10MSuperstar
Renowned |P_Money_50MMultimillionaire
Living Legend |P_Money_250MBillionaire
The Chosen One |P_Money_500MTrillionaire
Tourist::Visitor |TouristP_s_10
Collector::Native |CollectorP_s_25
Explorer::Obsessed |ExplorerP_s_50
Pathfinder |PathfinderP_s_100
Trailblazer |TrailblazerP_s_200
Seeker |500sP_s_500
Adventurer |750sP_s_750
Questing |1000sP_s_1000
Voyager |1250sP_s_1250
Lead-Follower |P_s_10Tourist
Extractor of Secrets |P_s_25Collector
Knows the Truth |P_s_50Explorer
Knows He/She Knows Not |P_s_100Pathfinder
Emissary |P_s_200Trailblazer
Overachiever |P_s_500500s
Doer |P_s_750750s
Prepared |P_s_10001000s
No Road Not Taken |P_s_12501250s
Tough::Stoic |ToughP_Damage_100K
Indestructible::Hard Case |IndestructableP_Damage_500K
Adamant::Ironman/woman |AdamantP_Damage_1M
Unbreakable |UnbreakableP_Damage_10M
Nigh Indestructible |NighIndestructableP_Damage_25M
Invulnerable |InvulnerableP_Damage_50M
Immortal |ImmortalP_Damage_100M
Slammer |P_Damage_100KTough
Big Dog |P_Damage_500KIndestructable
Laughs it Off |P_Damage_1MAdamant
Iron Willed |P_Damage_10MUnbreakable
Concussed |P_Damage_25MNighIndestructable
Marvel of Modern Medicine |P_Damage_50MInvulnerable
Challenger of Gods |P_Damage_100MImmortal
The Unwavering::Punch Drunk |UnwaveringFocusP_Debt_50K
The Unyielding::Unbroken |UnyieldingWillP_Debt_100K
The Unbroken Spirit::Relentless |UnbrokenSpiritP_Debt_200K
Deathless |DeathlessP_Debt_400K
Undying |UndyingP_Debt_600K
Exalted |ExaltedP_Debt_1M
Repaired |P_Debt_50KUnwaveringFocus
Went the Extra Mile |P_Debt_100KUnyieldingWill
Undaunted |P_Debt_200KUnbrokenSpirit
Impulsive |P_Debt_400KDeathless
Never Learns |P_Debt_600KUndying
Infinite Lives |P_Debt_1MExalted
Medic::Fixer |MedicP_Heal_250K
Surgeon::Doc |SurgeonP_Heal_1M
Doctor::Mad Scientist |DoctorP_Heal_2M
Medical Specialist |MedicalSpecialistP_Heal_3M
Medicine Man/Woman |MedicineManP_Heal_5M
Empath |EmpathP_Heal_10M
Do Gooder |P_Heal_250KMedic
Safekeeper |P_Heal_1MSurgeon
Clutch |P_Heal_2MDoctor
To The Rescue |P_Heal_3MMedicalSpecialist
Savior |P_Heal_5MMedicineMan
Death's Jailer |P_Heal_10MEmpath
Restrained::Slacker |RestrainedP_Held_10Min
Entangled::Sleepy |EntangledP_Held_30Min
Imprisoned::Dazed and Confused |ImprisonedP_Held_60Min
Confined |ConfinedP_Held_3Hour
Caged |CagedP_Held_6Hour
Jailed |JailedP_Held_12Hour
Waiting |P_Held_10MinRestrained
Locked Out |P_Held_30MinEntangled
Trapped |P_Held_60MinImprisoned
Stuck |P_Held_3HourConfined
Can't Do That |P_Held_6HourCaged
Lagged |P_Held_12HourJailed
Advisor::Comrade |AdvisorP_Mentor_4Hour
Guide::Drill Instructor |GuideP_Mentor_8Hour
Paragon::Svengali |ParagonP_Mentor_12Hour
Role Model |RoleModelP_Mentor_16Hour
Epitome |EpitomeP_Mentor_20Hour
Paradigm |ParadigmP_Mentor_24Hour
Encourager |P_Mentor_4HourAdvisor
Motivator |P_Mentor_8HourGuide
Teacher |P_Mentor_12HourParagon
Dean of Hard Knocks |P_Mentor_16HourRoleModel
Philosopher |P_Mentor_20HourEpitome
Old-Timer |P_Mentor_24HourParadigm
Annihilator |RogueHero
Demolitionist |RWZBomber
Firebase Zulu Security Detail::Firebase Zulu Deserter |FirebaseZuluSecurity
Troll Task Force Member |TrollTaskForce
No One Left Behind |I19HeroStoryArcOptional
Connected |I19VillainStoryArcOptional
Conspiracy Theorist |CreySetHeadlineStealer
Archmage |MagusSetDemonic
Vanguard |RiktiWarSetMegalomaniac
Geas of the Kind Ones |GeasoftheKindOnesMayhemForceOfNature
Yesterday's News::Headline Stealer |HeadlineStealerCreySet
Exorcised::Demonic |DemonicMagusSet
In Therapy::Megalomaniac |MegalomaniacRiktiWarSet
Uninsurable::Force of Nature |MayhemForceOfNatureGeasoftheKindOnes
Field Crafter |InventorAccolade
Watchman/woman |RIWEAccolade
Mission Engineer |ArchitectAccolade
Received the Atlas Medallion::Atlas Shrugged |AtlasSetMarshal
Portal Jockey |DimensionalHopperSetBornInBattle
Freedom Phalanx Reserve Member::Freedom Phalanx Fallen |FreedomPhalanxSetHighPainThreshold
Task Force Commander::Task Force Abandoner |TaskForceCommanderMayhemInvader
Ex-Marshal::Marshal |MarshalAtlasSet
Born in Battle |BornInBattleDimensionalHopperSet
Gotten Soft::High Pain Threshold |HighPainThresholdFreedomPhalanxSet
Return Visitor::Invader |MayhemInvaderTaskForceCommander
False Image::Mirage |MiragePatron
Shark Bait::Bloodletter |BloodInTheWaterPatron
Anti-Venom::Spider's Kiss |SpidersKissPatron
Fwoosh::The Stinger |TheStingerPatron
Received the Stalwart Medallion::Lost the Stalwart Medallion |StalwartMedallion
Earned the Statesman Star::Denied the Statesman Star |StatesmanStar
Awarded the Freedom Cross::Stripped of the Freedom Cross |FreedomCross
Thorn Robber |UnderTheKnife
Thorn Thief |NipTuck
Thorn Usurper |Facelifted
Alchemist |DJ_Alchemist
Anti-Arachnos Activist::Web Weaver |DJ_Web_Weaver
Archaeologist |DJ_Archaeologist
Blockade Runner::Profiteer |DJ_Black_Marketeer
Brood Leaver::Brood Leader |DJ_Brood_Leader
Defector::Black Ops |DJ_Black_Ops
Entrepreneur::Free Trade Advocate |DJ_Entrepreneur
Gladiator |DJ_Gladiator
Master Architect |DJ_Master_Architect
Mercenary |DJ_Soldier
Physician |DJ_Doctor
Police Chief::Corrupt Commissioner |DJ_Warden
Rapid Response Member::Trouble Maker |DJ_Rapid_Response_Member
Scientist::Crackpot |DJ_Scientist
Security Chief::Security Breach |DJ_Security_Chief
Socialite |DJ_Trend_Setter
Time Lord |DJ_Time_Traveler
Traveler::Border Crosser |DJ_Traveler
Whistleblower::Crey Scientist |DJ_Crey_Scientist
Atlas Tour Guide |AtlasParkExplorer
Galactic Explorer |GalaxyCityExplorer
PPD Informant::Former PPD Stoolie |KingsRowExplorer
Canyon Carver |SteelCanyonExplorer
Sky Gazer |SkywayCityExplorer
Faultline Finder |FaultlineExplorer
Island Hopper |TalosIslandExplorer
IP Address |IndependencePortExplorer
Citizen of Salamanca |CroatoaExplorer
Zig Warden::King/Queen of the Zig |BrickstownExplorer
Lost and Found |FoundersFallsExplorer
Portal Corp Analyst |PeregrineIslandExplorer
Apprentice Plumber |SewerNetworkExplorer
Master Plumber |AbSewerNetworkExplorer
Wincott's Ally::Wincott's Betrayer |HollowsExplorer
Perez Park Perfection |PerezParkExplorer
Boom... Goes the Town |BoomtownExplorer
Straight Through Striga |StrigaExplorer
Utilities Commission |TerraVoltaExplorer
A Light in Dark Astoria |DarkAstoriaExplorer
Crazy for Crey's Folly |CreysFolleyExplorer
Adam/Eve in Waiting |EdenExplorer
Busy, Busy Bee |TheHiveExplorer
All Your Firebase... |FirebaseZuluExplorer
Cascade Cleansing |CascadeArchExplorer
Can't Stop the Chant |ChantryExplorer
Storming the Palace |StormPalaceExplorer
Mercy Mariner |MercyIslandExplorer
Marcone Insider |PortOakesExplorer
Mad Science Supporter |CapAuDiableExplorer
Jumped the Shark |SharkheadExplorer
Nerva Navigator |NervaExplorer
Johnny's Ex-Best Friend::Johnny's Go To Guy/Gal |StMartialExplorer
Eye on Arachnos::Arachnos Spymaster |GrandvilleExplorer
Touched Bottom |AbyssExplorer
Honorary Monster |MonsterIslandExplorer
Knows Nova's Nooks |P_UndergroundNovaPraetoriaExplorer
Pure Praetorian |P_NovaPraetoriaExplorer
Beneath the Empire |P_UndergroundImperialCityExplorer
Emperor for a Day |P_ImperialCityExplorer
Neu You Could Do It |P_UndergroundNeutropolisExplorer
A Neu Man/Woman |P_NeutropolisExplorer
Alpha Unlocked |IncarnateAlphaSlot
Agent of Order::Agent of Chaos |P_GoingRogueAccoladeP_P_GoingRogueAccolade
Agent of Praetoria |P_P_GoingRogueAccoladeP_GoingRogueAccolade
Arena All-Star |InitiateAllStar
Bug Hunter |BetaTester
Force of Justice::Force of Injustice |SafeguardForceOfJustice
Hell and Back |Halloween09Accolade
Meticulous |Halloween2010Accolade
Pocket D VIP Gold Club Member |GoldClub
Praetoria's Son/Daughter |P_DVDEditionDVDEdition
Stouthearted::Stonehearted |SafeguardStouthearted
Ten times the Victor |Victor10
True to the Last |P_LoyaltyReward
V.I.P.::Destined One |DVDEditionP_DVDEdition
Vigilant::Determined |Vigilant
Viva Praetoria |P_VivaPraetoria
5th Columnist |5thGladiator
7th Generation Paragon Protector |ParagonProtect
Abomination |Abomination
Anathema |Anathema
Arachnobot |Arachnobot
Arachnoid |Arachnoid
Arch-Mage of Agony |ArchMage
Avalanche Shaman |Avalanche
Behemoth Overlord |Behemoth
Bladegrass |Bladegrass
Boulder |Boulder
Button Man Gunner |ButtonMan
Caliban |Caliban
Chief Swiper |Swiper
Cobra |Cobra
Cog |Cog
Coralax Blue Hybrid |Coralax
Crab Spider Longfang |CrabSpider
Crane Enforcer |Crane
Crey Power Tank |PowerTank
Ember Legacy of Flame |LegacyFlame
Fire Thorn Caster |FireCaster
Fortunata Seer |Fortunata
Fungoid |Fungoid
Gremlin |Gremlin
Hellfrost |Hellstrike
Hordeling Lasher |Lasher
Hercules Titan |Titan
Hydra Protean |Protean
Ink Man |InkMan
Juicer |JuicerSniper
Kaolin Legacy of Earth |LegacyEarth
Longbow Nullifier |Nullifier
Longbow Rifleman |LongbowRifleman
Longbow Spec-Ops |SpecOps
Longbow Warden 1 |LongbowTanker
Longbow Warden 2 |LongbowDefender
Lucent Legacy of Light |LegacyLight
Meson |Meson
Mob Specialist |MobSpec
Mook |Mook
Mook Capo |Capo
Mu Guardian |MuGuardian
Nebula Elite Buckshot |NebulaBuckshot
Nemesis Soldier |NemesisSoldier
Night Haunt |PirateGhost
Night Widow |NightWidow
Outcast Slugger |Slugger
Omega Wolf |OmegaWolf
Pariah Anchorite |Anchorite
Penumbra Elite Adjutant |Penumbra
Raider Engineer |RaiderEngineer
Red Cap |RedcapGladiator
Red Hand |RedHand
Research Assistant |ResearchAsst
Rikti Drone |RiktiDrone
Shivan Destroyer |ShivanDestroyer
Slag Pile |SlagPile
Smasher Elite |WarriorSmasher
Snowbeast |WinterMinion
Sorcerer |Sorcerer
Steel Strongman |Strongman
Swift Steel |SwiftSteel
Tank Smasher |TankSmasher
Tarantula |Tarantula
Wailer |Wailer
Wailer Queen |WailerQueen
Warhulk |Warhulk
Wolf Spider Enforcer |WolfSpider
Wolf Spider Tac Ops |TacOps
Wraith |Wraith
Zenith Warcry Mk I |Warcry
Grand Lanista |GrandLanista
Lanista |Lanista
Trustworthy |Veteran3
Faithful |Veteran6
Dependable |Veteran9
Loyal |Veteran12
Zealous |Veteran15
Staunch |Veteran18
Steadfast |Veteran21
Devoted |Veteran24
Dedicated |Veteran27
Committed |Veteran30
Unswerving |Veteran33
Addicted |Veteran36
Ardent |Veteran39
Fervent |Veteran42
Eternal |Veteran45
Battle Hardened |Veteran48
Tried and True |Veteran51
Allegiant |Veteran54
Abiding |Veteran57
City Traveler |Veteran60
Honorable |Veteran63
Enduring |Veteran66
Genuine |Veteran69
Distinguished |Veteran72
Purposeful |Veteran78
Resolute |Veteran75
Agent Provocateur |AgentProvocateur
Risk Taker::Most Wanted |MostWanted
Vigilante::Wanted |Wanted
Arena Victor |1ArenaWin
Arena Duelist |1WinDuel
Tournament Victor |1WinSwissDraw
Arena Survivalist |1WinFreeForAll
Pentad Victor |1WinPentad
Strawweight Champion |Strawweight
Flyweight Champion |Flyweight
Bantamweight Champion |Bantamweight
Featherweight Champion |Featherweight
Lightweight Champion |Lightweight
Welterweight Champion |Welterweight
Middleweight Champion |Middleweight
Cruiserweight Champion |Cruiserweight
Heavyweight Champion |Heavyweight
Super Heavyweight Champion |SuperHeavyweight
Reinforcement |Ace
Forward Observer |Manhunter
Disruptor |Headhunter
Irradiated |BloodyBay
Siren's Song::Raider |SirensCall
Web Master |Warburg
Time Traveler |RecluseVictory
Temporal Agent |RVHeavy10
Temporal Spy |RVHeavy50
Temporal Soldier |RVHeavy250
Oppressor |RVStatesman
Destroyer |RVPositron
Dead-eye |RVManticore
Interrogator |RVSisterPsyche
Breakneck |RVSynapse
Uppercut |RVBackAlleyBrawler
Redeemed Blackguard::Blackguard |RVAllHeroes
Arachnophobic |RVLordRecluse
Wrangler |RVBlackScorpion
Poltergeist |RVGhostWidow
Sandblasted |RVScirocco
Shark Hunter |RVCaptainMako
Justiciar::Fallen Justiciar |RVAllVillains
Time Machinist |RVPillbox10
Somewhere in Time |RVPillbox100
Back From the Future |RVPillbox1000
Gunner |Gunner
Power Liberator::Master Thief |MasterThief
Rocketman/woman |Rocketman
Artisan |InventionLevel1
Master Artisan |InventionLevel2
Craftsman |InventionLevel3
Master Craftsman |InventionLevel4
Fabricator |InventionLevel5
Declining |InventionDeBuff1
Decaying |InventionDeBuff2
Despoiler |InventionDeBuff3
Dismantler |InventionDeBuff4
Retrograde |InventionDeBuff5
Medicator |InventionHeal1
Mender |InventionHeal2
Rebuilder |InventionHeal3
Revivifier |InventionHeal4
Reanimator |InventionHeal5
Armorer |InventionMitigation1
Guardian |InventionMitigation2
Protector |InventionMitigation3
Security |InventionMitigation4
Defensive |InventionMitigation5
Blinding |InventionMez1
Beguiler |InventionMez2
Charming |InventionMez3
Charismatic |InventionMez4
Mesmerizer |InventionMez5
Energy Conservationist |InventionEndurance1
Battery Powered |InventionEndurance2
Nuclear Powered |InventionEndurance3
Mystically Powered |InventionEndurance4
Perpetual |InventionEndurance5
Trigger Man |InventionRateOfFire1
Hired Gun |InventionRateOfFire2
Hit-Man |InventionRateOfFire3
Sniper |InventionRateOfFire4
Sharpshooter |InventionRateOfFire5
Major |InventionAccuracy1
Lt. Colonel |InventionAccuracy2
Colonel |InventionAccuracy3
Major General |InventionAccuracy4
General |InventionAccuracy5
Munitionist |InventionDamage1
Weaponeer |InventionDamage2
Warhead |InventionDamage3
Arms Dealer |InventionDamage4
Lord of War |InventionDamage5
Pilgrim |InventionTravel1
Vagabond |InventionTravel2
Wanderer |InventionTravel3
Walks the Earth |InventionTravel4
Nomad |InventionTravel5
Inventor |InventTutorial
Anger Manager::Vandal |MayhemVandal
Army of Me |Defeat8ClonesChallenge
Bane of Dannan |BaneofDannan
Banisher |Banisher
Believer |Believer
Blindsider |P_DefeatSeers
Bloody Hands::Hero Slayer |MayhemHeroSlayer
Bomb Specialist |RIWEDefeatUXB
Bonecrusher |Bonecrusher
Cannibal |P_DefeatGhouls
Cap Buster |CapBuster
Centurion |Cimerorans
Chief |RIWEDefeatHeavies
Clockstopper |Clockstopper
Coldblooded::Coldhearted |ThornIsle1
Dee Jay |TrollsRaveSmasher
Demon Slayer |DemonSlayer
Devilfish |OctopusEvent
Dimensional Warder |DimensionalWarder
Diplomat::Breathes Easy |STFVictory3
Ectoplasmic |GhostShipDefeats
Electrician |DeathSurge
Escapee |P_DefeatFailedExperiments
Ex-Archvillain::Archvillain |DefeatStatesman
Eye of the Storm |P_DefeatMaelstrom
Finder |Finder
Fire Chief::Asbestos |HellionsFireGold
Firefighter::Firestomper |HellionsFireSilver
Fort Knox |FortKnox
Gangbuster |Gangbuster
Gearsmasher |Gearsmasher
Giant Killer |GiantKiller
Goon Squad |GoonSquad
Gravedigger |Gravedigger
Hammer Down |Scrapyard
Hammerhead |Hammerhead
Haunted |Haunted
Heat Seeker |ArachnosFlier
HellBane |ThornIsle2
Hellspawned |Hellspawned
Illusionist |Illusionist
Infiltrator |Infiltrator
Isolator |Quarantine
Judge & Jury::Merciless |P_DefeatRGC
Keeper of Secrets |KeeperOfSecrets
Kill Skuls |Bonecrusher2
Knight Errant::Black Knight |ClockworkPaladinEvent
Legionnaire |Legionnaire
Locksmith::Safecracker |MayhemSafeCracker
Man/Woman in Black |ManinBlack
Marked for Death |P_DefeatSyndicate
Master At Arms |RWZMasterAtArms
Master/Mistress of Olympus |MasterOfOlympus
Monkeywrencher |Monkeywrencher
The Mongoose |TheMongoose
No Authority |P_DefeatPPD
Pirate |GhostTrap50
Privateer |Privateer
Protectorate::Devourer of Earth |Protectorate
Pumpkin King/Queen |PumpkinKing
Pumpkin Master/Mistress |PumpkinMaster
Raver |TrollsRaveRoundup
Redundant |P_DefeatTheDestroyers
Reformed::Villain |Villain
Regenerator |Regenerator
Resistance is Futile |P_DefeatResistance
Roman |RomulusDefeated
Sentry |RIWEDefeatInvaders
Soul Binder |SoulBinder
Spectral |GhostTrap100
Spellbinding |Spellbinding
Spider Smasher |SpiderSmasher
Statesman's Pal::Praetoria's Bane |StatesmansPal
Strike Buster |StrikeBuster
Surging |Surging
Tank Buster |Blitzkrieg
Technophobe |P_DefeatClockwork
The Silver Bullet |SilverBullet
The Slayer |Slayer
The Solution |TheSolution
Thin Line::Outlaw |MayhemOutlaw
Tracer |Tracer
Unleasher |Unleasher
Untouchable |Untouchable
Unveiler |Unveiler
Usurper |DefeatRecluse
Venomous |Venomous
Villain Disruptor |SafeguardVillainDisruptor
Visionary |Visionary
Volcanic |Volcanic
Volunteer Firefighter::Fire Bane |HellionsFireBronze
Warden::Cruel Warden |Warden
Weatherman/girl |Weatherman
Weed Whacker |WeedWhacker
Whip Cracker |P_DefeatDesdemona
Zookeeper |Zookeeper
Celebrant |Anniversary1
Reveler |Anniversary2
Merrymaker |Anniversary3
Entertainer |Anniversary4
Jubilant |Anniversary5
Exultant |Anniversary6
Pursuer::Elusive |CoVAnniversary
Partygoer |_PocketD_Jubilee
Heart of Light::Heart of Darkness |ValentineLogin
Handsome/Beautiful |LovePotion
Toothbreaker |Hunt
Clothes Horse |Halloween20071
Fashionable |Halloween20072
Ostentatious |Halloween20073
Dark Fiend |Halloween09DarkFiend
Hell Hath No Fury |Halloween09WomenScorned
Terror |Halloween09Terrors
Monster Masher |Halloween09Monster
Monstrous |Halloween09MonsterGM
Ghost Touched |GhostTouched
Iron Warrior |IronWarrior
Hallow Spirit |HallowSpirit
Hunter |Hunter
Buster |Buster
Shifter |Shifter
Dead Head |DeadHead
Malleus |Malleus
Secured |Halloween2010Secured
Power Hungry |Halloween2010PowerHungry
Artifact Destroyer |Halloween2010ArtifactDestroyer
Veiled |Halloween2010Veiled
Arriviste |Halloween2010Arriviste
Trusting |Halloween2010Trusting
Glimpsed the Abyss |Halloween20081
Safety in Numbers |Halloween20082
Evil's Resident |Halloween20083
Apocalypse Survivor |Halloween20084
Miraculous |Miraculous
Joyful |Joyful
Frosty |Frosty
Crystallized |Crystallized
Longbow Reservist::Jet-Setter |Holiday20051
Cold Front |ColdFront
Gifted |Winter2007
Frostbitten |Winter2008
Festive |Winter2009
Cold Warrior |SnowmenDefeat
Frozen Fury |SnowbeastDefeat
Holiday Spirit::Scrooge |Holiday20052
Lord/Lady of Winter |Winter2009DefeatLordWinter
Toy Collector |Holiday20053
###MISSING INFO### |Holiday2010
Passport |ServerTransfer
Troubleshooter |Flashback5
Adjuster |Flashback10
Calibrator |Flashback15
Alterist |Flashback20
Balancer |Flashback25
Correctionist |Flashback30
Repairman/Repairwoman |Flashback35
Overhauler |Flashback40
Time Fixer |Flashback45
Ouroboros Mender |Flashback50
All For One, One For All |LivesTeamPool0
Divided Mastery |LivesTeamPool1
Proportional Supremacy |LivesTeamPool3
Shared Victory |LivesTeamPool5
Bronze Medalist |TimeLimitBronze
Silver Medalist |TimeLimitSilver
Gold Medalist |TimeLimitGold
Venturous |DeBuffedPartyatSL2
Headstrong |DeBuffedPartyatSL3
Adventurous |DeBuffedPartyatSL4
Daredevil |DeBuffedPartyatSL5
Rash |DeBuffedPartyatSL6
Venturesome |DeBuffedPartyatSL7
Reckless |DeBuffedPartyatSL8
Temerarious |DeBuffedPartyatSL9
Audacious |BuffedEnemiesatSL2
Courageous |BuffedEnemiesatSL3
Bold |BuffedEnemiesatSL4
Fearless |BuffedEnemiesatSL5
Valiant |BuffedEnemiesatSL6
Stalwart |BuffedEnemiesatSL7
Lionhearted |BuffedEnemiesatSL8
Intrepid |BuffedEnemiesatSL9
Contributor |ArchetypePowersOnlyatSL2
Vocational |ArchetypePowersOnlyatSL3
Professional |ArchetypePowersOnlyatSL4
All Business |ArchetypePowersOnlyatSL5
Archetypical |ArchetypePowersOnlyatSL6
Obligated |ArchetypePowersOnlyatSL7
Missionary |ArchetypePowersOnlyatSL8
Undertaker |ArchetypePowersOnlyatSL9
Refrained |NoTravelPowersatSL2
Shut Down |NoTravelPowersatSL3
Desisted |NoTravelPowersatSL4
Barred |NoTravelPowersatSL5
Still |NoTravelPowersatSL6
Stalled |NoTravelPowersatSL7
Stemmed |NoTravelPowersatSL8
Suspended |NoTravelPowersatSL9
Diminished |NoTemporaryPowersatSL2
Curtailed |NoTemporaryPowersatSL3
Capped |NoTemporaryPowersatSL4
Inhibited |NoTemporaryPowersatSL5
Hindered |NoTemporaryPowersatSL6
Bound |NoTemporaryPowersatSL7
Limited |NoTemporaryPowersatSL8
Demarcated |NoTemporaryPowersatSL9
Cut-Off |NoEpicPowersatSL8
Marginalized |NoEpicPowersatSL9
Cliche |NoInspirationsatSL2
Unimaginative |NoInspirationsatSL3
Flat |NoInspirationsatSL4
Unoriginal |NoInspirationsatSL5
Dull |NoInspirationsatSL6
Phoned It In |NoInspirationsatSL7
Indifferent |NoInspirationsatSL8
Uninspired |NoInspirationsatSL9
Lessened |NoEnhancementsatSL2
Debilitated |NoEnhancementsatSL3
Anemic |NoEnhancementsatSL4
Weakened |NoEnhancementsatSL5
Deflated |NoEnhancementsatSL6
Decreased |NoEnhancementsatSL7
Devalued |NoEnhancementsatSL8
Unenhanced |NoEnhancementsatSL9
Entrusted with the Secret |OuroborosEnabled
Vendor |AuctionSeller1
Salesman/Saleswoman |AuctionSeller2
Tradesman/Tradeswoman |AuctionSeller3
Merchant |AuctionSeller4
Peddler |AuctionSeller5
Retailer |AuctionSeller6
Dealer |AuctionSeller7
Auctioneer |AuctionSeller8
Businessman/Businesswoman |AuctionSeller9
Marketer::Black Martketeer |AuctionSeller10
Shopkeeper |AuctionSeller11
Power Seller |AuctionSeller12
Broker |AuctionRecipes
Inspiring |AuctionInspirations
Scrounger |AuctionSalvage
Enhancer |AuctionEnhancements
Arachnos Traitor::Arachnos Official |DJ_Arachnos_Official
Architect |DJ_Architect
Banker::Thief |DJ_Banker
Cannon Fodder::Arachnos Agent |DJ_Arachnos_Agent
Caregiver::Pain Specialist |DJ_Caregiver
Chronologist |DJ_Mender
Cimeroran |DJ_Cimeroran
City Official::Ousted Official |DJ_City_Official
Clubber |DJ_Clubber
Commuter::Fare Jumper |DJ_Commuter
Crey Test Subject::Crey Employee |DJ_Crey_Employee
Day Trader::Marketeer |DJ_Auctioneer
Dimensional Explorer::Dimensional Plunderer |DJ_Dimensional_Explorer
Duelist |DJ_Duelist
Fashion Designer |DJ_Clotheshorse
Grounded::Pilot |DJ_Pilot
Gunrunner::Smuggler |DJ_Smuggler
Intern::Wage Slave |DJ_Intern
Law Enforcer::Dirty Cop |DJ_Law_Enforcement
Midnighter |DJ_Midnighter
Monitor Duty |DJ_Monitor_Duty
Mortician |DJ_Gravedigger
Patroller (Praetorian Origin)::Criminal |P_DJ_On_Patrol
Patroller::Criminal |DJ_On_Patrol
Predator |DJ_Griefer
Professional Liar::Demagogue |DJ_Demagogue
Professor |DJ_Scholar
Shop Keeper::Price Gouger |DJ_Shop_Keeper
Vanguard Recruit |DJ_Vanguard_Recruit
Destructive |ArchitectDestroy1
Extractor |ArchitectRescue1
Poor Impulse Control |ArchitectClick10
Workaholic |ArchitectNonRequiredObjective25
Admiring |ArchitectPlayDevChoice1
Critic |ArchitectHallofFame5
Cunning |ArchitectRogueMission
Early Bird |ArchitectFirstPlay
Gamer |ArchitectPlay25
Heroic |ArchitectHeroMissions10
Villainous |ArchitectVillainMissions10
Walks the Line |ArchitectVigilanteMission
Author |ArchitectAuthor50
Recognized |ArchitectTotalStars100
Among Friends |ArchitectTest8
Bug Fixer |ArchitectTestOwnMission
Virtual Destruction |ArchitectTestDestroy1
Virtual Extractor |ArchitectTestRescue1
Virtual Victim |ArchitectDefeatedinTest
Virtual Victor |ArchitectTestKill10
Virtually Impulsive |ArchitectTestClick1
Payoff |ArchitectPurchase
Ticket Taker |ArchitectTickets100
Architect X |Architects10
Architect XXV |Architects25
Assassin |ArchitectCustomKills50
Customizer |ArchitectCustomBoss
Energized |ArchitectInspirations10
Atlas Park Beacon |BeaconAtlasPark
Galaxy City Beacon |BeaconGalaxyCity
Kings Row Beacon |BeaconKingsRow
Steel Canyon Beacon |BeaconSteelCanyon
Skyway City Beacon |BeaconSkywayCity
Faultline Beacon |BeaconFaultline
Talos Island Beacon |BeaconTalosIsland
Independence Port Beacon |BeaconIndependencePort
Croatoa Beacon |BeaconCroatoa
Brickstown Beacon |BeaconBrickstown
Founders Falls Beacon |BeaconFoundersFalls
Peregrine Island Beacon |BeaconPeregrineIsland
The Hollows Beacon |BeaconTheHollows
Perez Park Beacon |BeaconPerezPark
Boomtown Beacon |BeaconBoomTown
Striga Isle Beacon |BeaconStriga
Terra Volta Beacon |BeaconTerraVolta
Dark Astoria Beacon |BeaconDarkAstoria
Crey's Folly Beacon |BeaconCreysFolly
Eden Beacon |BeaconEden
Mercy Isle Beacon |BeaconMercy
Port Oakes Beacon |BeaconPortOakes
Cap au Diable Beacon |BeaconCap
Sharkhead Isle Beacon |BeaconSharkhead
Nerva Beacon |BeaconNerva
St. Martial Beacon |BeaconStMartial
Grandville Beacon |BeaconGrandville
Rikti War Zone Beacon |BeaconRiktiCrashSite
Pocket D Beacon |BeaconPocketD
Analyzer Base Defense |AnalyzerTurret
Gas Trap Base Defense |GasTrap
Improved Energy Turret |ImpEnergyBeam
Repulsor Base Defense |Repulsor
Benedict DR Turret Plans |DampeningRay
Benedict DR-3 Turret Plans |EliteDampeningRay
Benedict DR-2 Turret Plans |ImpDampeningRay
Supercomputer |Supercomputer
Autonomous Expert System Plans |SyntheticIntel
Mega Monitor Plans |EdgeMonitor
Emergency Capacitor Plans |EmergencyCapacitor
Auto-Doc Plans |MedAdvisor
Robo-Surgery Plans |DoctorsDesk
Combat Log Plans |CombatLog
Fusion Generator Plans |FusionGenerator
Improved Igniter |ImpIgniter
Scorpian's Surprise |ScorpionTurret
Ritki Plasma Turret |RiktiTurret
